....................
....................
................ee..
........S.....bgrbo.
.......ROY..........
..S.................
.GGR................
.......sss..........
.......BGR....o.....
.+............b.S.e.
rrbbggooyyrbgoyrbgoy