....................
....................
........rbgoy.......
....................
.ryoGBR.............
....................
.........OYR........
....................
....RBG......BGO....
.+..................
rrbbggooyyrbgoyrbgoy