.........+..........
........BBR.........
...s................
..ROY...............
.........e..........
........BBG....e....
............b.bbb...
....................
...................B
.e..e...SSS..e......
rrbbggooyyrbgoyrbgoy